$ 15 , 15

 . # . . . . . # . . . . . . v 
 . # . # . # . # . # # # . # . 
 . . # . . . . # . . . . . # . 
 . # . # . # . # . # . # . # . 
 . . . . . # . # . . . . . . . 
 . # # # . # . # . # . # . # . 
 . . . . . . . . . . . . . # . 
 # # # # # # . # . # # # . # . 
 . . . . . . . . . . # . . . . 
 . # . # . # . # . # . # . # . 
 . # . . # . . . . . . . . . . 
 . # . # . # . # # # . # . # # 
 . . . . . # . . . . # . . . . 
 . # # # . # . # . # . # . # . 
 v # . . . . . . . # . . . # v 
