$ 15 , 15

 . # . . . . . . . . . . . . . 
 . # . # . # . # . # # # . # . 
 . # # . . . . # . . . . . # . 
 . # . # . # . # . # . # . # . 
 . # . . . # . # . . . # . . . 
 . # # # # * . * * * . # . # . 
 . . . . . . . . . * . . . # . 
 # # # # # * . * . * # # # # . 
 . . . . . * . . . * . . . . . 
 . # . # . * * * * * . # . # . 
 . # v # . . . . . . # . . . . 
 . # # # . # . # # # . # . # # 
 . . . . . # . . . # . . . . . 
 . # # # . # . # . # . # . # . 
 . # . . . . . # . . . . . # . 
